##############@###############
#            # #             #
#  z         # #             #
#    #              #    D   #
#        #         # #       #
#    # ###                   #
#                  #         #
#    #             #         #
#        #         # #       #
#    #             ###       #
#                            #
##############################